                      +------------+------------+                       
       +---+----+-----+............|............+---------------+       
       |....>> > >    |............|............|...............|       
       |...=,,,,,,    |............|............|...............|       
       |....<< < <    |............|............|...............|       
       +-/------------+l-----------+-----------L+-------------l-+       
       |b......................................................b|       
       :b.....................................................bb:       
       |bbbb....+------------------+------------------+....bbbbb|       
+------+---+....|..................|..................|....+----+------+
|h.........l....|..................|..................|....\..CCCCC..dh|
:h.........p....|..................|..................|....p.ct....dcdh:
|h.........|....|..................|..................|....|.c.c...dddh|
+----------+....|..................|..................|....+-----------+
|h.........|....|..................|..................|....|[........dh|
:h.........p....|..................|..................|....p[.......cdh:
|h.........L....|..................|..................|....l.......dddh|
+----------+....+--------+---------+-------------+----+....p+----------+
|h.........l....|........|d.....d|...............|ddd.l.....\.BB..ddddh|
:h.........p....|........|d.....d|...............|.cd.L.....p.c....cc.h:
|h.........|....+--------|d.....d+----------+----+----+b....|dddd.ddddh|
+----------+....|d..............d|...tttttt.|.........|b....+----------+
|h.........|....|d..............d|.x.....c..|.........|b....|Fddddddddh|
:h.........p....|d..............d|..c...ddd.|.........|.....p..c...cc.h:
|h.........L....|d;.............d|.ddd....c.|.........|...../.BB..ddddh|
+----------+....|d..............d|..c....c..|.........|b....+----------+
|h.........l....|d...tttttttt...d|...c...ct.|x+-------+b....L..cddddd.h|
:h.........p....|dc.............d|.ddd..+---+-+ ^^^^^ |b....p.t...c..Ch:
|h.........|....|d.....c...c....d|..c...| ^^^ | ^^^^^ |.....|c.c.....Ch|
+----------+....|.....ddddddddddd|......+-ggg-*-ggggg-+.....P----------+
|h.c..CCC.c|....+-lp---------------+-p\-+...................|dddd...c.h|
:hctc....../................................................L.c...ddddh:
:hctc......p................................................l.c...ddddh:
|h&.KKKSKKK|....+-Lp-PPP----+-Lp--------+...................|dddd..c..h|
+----------+....|...........|...........+-PPP---+-ggg-+.....+----------+
|hdddd.CCCC|....|...........|...........|xxxxxxx| ^^^ |.....|.........h|
:h.cc......p....|...........|...........|xxxxxxx+-----+b....p.....c...h:
|hdddddddd.L....|...........|...........+------++.YY..|b....l...ddddd.h|
+----------+....|...........|...........|......|R.....|b....+----------+
|h.........l....|...........|...........|......|s.....p.....L...ddddd.h|
:h.........p....|...........|...........|......|R.....\.....p..c..c...h:
|h.........|....|...........|...........|......+------+b....|...ctc...h|
+----------+....|...........|...........|......|xxxxxx|b....+----------+
|h.........|....+--------+..+-----------+-\----+---/--+b....|.........h|
:h.........p....|..xxxxxx|.........\..................l.....p.....c...h:
|h.........L....|..xxxxxx|.........|..................L.....l...ddddd.h|
+----------+....+--------+---------|..................|....+-----------+
|h.........l....|........\.........|..................|....L..........h|
:h.........|....|......../.........|..................|....p.c.tc...dch:
|h.........p....+--------+.........|..................|....|........ddh|
+----------+....|..................|..................|....+-----------+
|h.........|....|....|.............|..................|....|.c........h|
:h.........p....|....|.............|..................|....p.tc....c..h:
|h.........L....|....|.............|..................|....l.....dddddx|
+------+---+....|....|.............|..................|....+----+------+
       |bbbb....+-lL-+-------------+------------------+....bbbbb|       
       :b.....................................................bb:       
       |b......................................................b|       
       +-\------------+-L----------+----------l-+-L+--------!+\-+       
       |....>> > >    |............|............|..|T..|T|S.S|..|       
       |...=,,,,,,    |............|............|..|...|/|......|       
       |....<< < <    |............|............|..|...\........|       
       +---+----+-----+............|............+--+------------+       
                      +------------+------------+                       